#############################
# M   M   M   M   M        #
#                         #
# M   M   M   M   M        #
#                         #
#     B   B               #
#                         #
# M   M   M   M   M        #
#                         #
#         C   C           #
#############################
