###############################
# M   M   M   M   M          #
#                           #
# M   M   M   M   M          #
#                           #
# M   M   M   M   M          #
#                           #
# M   M   M   M   M          #
#                           #
# M   M   M   M   M          #
#                           #
#                           #
#         B   B   C   C      #
###############################
