###########
# B   M M #
#     M M #
# C       #
###########
